Vaktpost	Vaktposten låter dig rekrytera Pikenerare.
Bågskyttstorn	Bågskyttetornet låter dig rekrytera Bågskyttar.
Griptorn	Griptornet låter dig rekrytera Gripar.
Barack	Baracken låter dig rekrytera Fäktare.
Kloster	Klostret låter dig rekrytera Munkar.
Träningsområde	Träningsområdet låter dig rekrytera Ryttare.
Pärleport	Pärleporten låter dig rekrytera Änglar.
Upg. Vaktpost	Vaktposten låter dig rekrytera Hillebardjärer.
Upg. Bågskyttstorn	Bågskyttetornet låter dig rekrytera Prickskyttar.
Upg. Griptorn	Griptornet låter dig rekrytera Kungagripar.
Upg. Barack	Baracken låter dig rekrytera Korsfarare.
Upg. Kloster	Klostret låter dig rekrytera Seloter.
Upg. Träningsområde	Träningsområdet låter dig rekrytera Tornerare.
Upg. Pärleport	Pärleporten låter dig rekrytera Ärkeänglar.
Kentaurstall	Kentaurstallet låter dig rekrytera Kentaurer.
Dvärgstuga	Dvärgstugan låter dig rekrytera Dvärgar.
Hemman	Hemmanen låter dig rekrytera Skogsalver.
Förtrollad källa	Den Förtrollade Källan låter dig rekrytera Pegaser.
Dendroidglänta	Dendroidgläntan låter dig rekrytera Dendroidvakter.
Enhörningsdunge	Enhörningsdungen låter dig rekrytera Enhörningar.
Drakklippa	Drakklippan låter dig rekrytera Gröndrakar.
Upg. Kentaurstall	Kentaurstallen låter dig rekrytera Kentaurkaptener.
Upg. Dvärgstuga	Dvärgstugan låter dig rekrytera Stridsdvärgar.
Upg. Hemman	Hemmanen låter dig rekrytera Storalver.
Upg. Förtrollad Källa	Den Förtrollade Källan låter dig rekrytera Silverpegaser.
Upg. Dendroidglänta	Dendroidgläntan låter dig rekrytera Dendroidsoldater.
Upg. Enhörningsdunge	Enhörningsdungen låter dig rekrytera Stridsenhörningar.
Upg. Drakklippa	Drakklippan låter dig rekrytera Gulddrakar.
Verkstad	Verkstaden låter dig rekrytera Småtomtar.
Balustrad	Balustraden låter dig rekrytera Stenfilurer.
Golemfabrik	Golemfabriken låter dig rekrytera Stengolemer.
Magikertorn	Magikertornet låter dig rekrytera Magiker.
Önskealtare	Önskealtaret låter dig rekrytera Djinner.
Guldpaviljong	Guldpaviljongen låter dig rekrytera Naga.
Molntempel	Molntemplet låter dig rekrytera Jättar.
Upg. Verkstad	Verkstaden låter dig rekrytera Stortomtar.
Upg. Balustrad	Balustraden låter dig rekrytera Obsidianfilurer.
Upg. Golemfabrik	Golemfabriken låter dig rekrytera Järngolemer.
Upg. Magikertorn	Magikertornet låter dig rekrytera Ärkemagiker.
Upg. Önskealtare	Önskealtaret låter dig rekrytera Mästardjinner.
Upg. Guldpaviljong	Guldpaviljongen låter dig rekrytera Nagadrottningar.
Upg. Molntempel	Molntemplet låter dig rekrytera Titaner.
Pukdegel	Impdegeln låter dig rekrytera Pukar.
Syndernas Sal	Syndernas Sal låter dig rekrytera Gogar.
Kennel	Kenneln låter dig rekrytera Helveteshundar.
Demonport	Demonporten låter dig rekrytera Demoner.
Helvetesgap	Helvetesgapet låter dig rekrytera Avgrundsbövlar.
Eldsjö	Eldsjön låter dig rekrytera Ifriter.
Övergivet Palats	Det Övergivna Palatset låter dig rekrytera Djävlar.
Upg. Pukdegel	Pukdegeln låter dig rekrytera Bjäror.
Upg. Syndernas sal	Syndernas Sal låter dig rekrytera Magogar.
Upg. Kennel	Kenneln låter dig rekrytera Cerberi.
Upg. Demonport	Demonporten låter dig rekrtytera Behornade Demoner.
Upg. Helvetesgap	Helvetesgapet låter dig rekrytera Avgrundsmästare.
Upg. Eldsjö	Eldsjön låter dig rekrytera Ifritsultaner.
Upg. Övergivet Palats	Det Övergivna Palatset låter dig rekrytera Ärkedjävlar.
Förbannat Tempel	Det Förbannade Templet låter dig rekrytera Skelett.
Kyrkogård	Kyrkogården låter dig rekrytera Dödgångare.
Själsgrav	Själsgraven låter dig rekrytera Gastar.
Gods	Godset låter dig rekrytera Vampyrer.
Mausoleum	Mausoleumet låter dig rekrytera Likhäxor.
Mörkrets Sal	Mörkrets Sal låter dig rekrytera Svartriddare.
Darkvalv	Drakvalvet låter dig rekrytera Bendrakar.
Upg. Förbannat Tempel	Det Förbannade Templet låter dig rekrytera Skelettkrigare.
Upg. Kyrkogård	Kyrkogården låter dig rekrytera Draugar.
Upg. Själsgrav	Själsgraven låter dig rekrytera Vålnader.
Upg. Gods	Godset låter dig rekrytera Vampyrherrar.
Upg. Mausoleum	Mausoleumet låter dig rekrytera Kraftfulla Likhäxor.
Upg. Mörkrets sal	Mörkrets Sal låter dig rekrytera Skräckriddare.
Upg. Drakvalv	Drakvalvet låter dig rekrytera Spökdrakar.
Grotta	Grottan låter dig rekrytera Troglodyter.
Vråkloft	Vråkloftet låter dig rekrytera Harpyor.
Ögonpelare	Ögonpelaren låter dig rekrytera Åskådare.
Tysta Rösternas Kapell	Tysta Rösternas Kapell låter dig rekrytera Medusor.
Labyrint	Labyrinten låter dig rekrytera Minotaurer.
Manticore Lair	The Manticore Lair allows you to recruit Manticores.
Drakgrotta	Drakgrottan låter dig rekrytera Röddrakar.
Upg. Grotta	Grottan låter dig rekrytera Infernaliska Troglodyter.
Upg. Vråkloft	Vråkloftet låter dig rekrytera Vildvittror.
Upg. Ögonpelare	Ögonpelaren låter dig rekrytera Onda Ögon.
Upg. Tysta Rösternas Kapell	Tysta Rösternas Kapell låter dig rekrytera Medusadrottningar.
Upg. Labyrint	Labyrinten låter dig rekrytera Minotaurkungar.
Upg. Manticore Lair	The Manticore Lair allows you to recruit Scorpicores.
Upg. Drakgrotta	Drakgrottan låter dig rekrytera Svartdrakar.
Koboldbarack	Koboldbarackerna låter dig rekrytera Kobolder.
Varggryt	Varggrytet låter dig rekrytera Vargryttare.
Orchtorn	Orchtornet låter dig rekrytera Orcher.
Resefort	Resefortet låter dig rekrytera Resar.
Klippnäste	Klippnästet låter dig rekrytera Rockar.
Cyklopgrotta	Cyklopgrottan låter dig rekrytera Cykloper.
Behemotlya	Behemotlyan låter dig rekrytera Behemoter.
Upg. Koboldbarack	Koboldbaracken låter dig rekrytera Hobkobolder.
Upg. Varggryt	Varggrytet låter dig rekrytera Vargplundrare.
Upg. Orchtorn	Orchtornet låter dig rekrytera Orchöverhuvuden.
Upg. Resefort	Resefortet låter dig rekrytera Bergsresar.
Upg. Klippnäste	Klippnästet låter dig rekrytera Åskfåglar.
Upg. Cyklopgrotta	Cyklopgrottan låter dig rekrytera Cyklopkungar.
Upg. Behemotlya	Behemotlyan låter dig rekrytera Urtida Behemoter.
Krokotaurstuga	Krokotaurstugan låter dig rekrytera Krokotaurer.
Ödlehåla	Ödlehålan låter dig rekrytera Ödlemän.
Sländebo	Sländeboet låter dig rekrytera Dagssländor.
Basiliskhåla	Basiliskhålan låter dig rekrytera Basilisker.
Gorgonlya	Gorgonlyan låter dig rekrytera Gorgoner.
Lindormsnäste	Lindormsnästet låter dig rekrytera Lindormar.
Hydrans damm	Hydrans damm låter dig rekrytera Hydror.
Upg. Krokotaurstuga	Krokotaurstugan låter dig rekrytera Krokotaurmarodörer.
Upg. Ödlehåla	Ödlehålan låter dig rekrytera Ödlekrigare.
Upg. Sländebo	Sländeboet låter dig rekrytera Trollsländor.
Upg. Basiliskhåla	Basiliskhålan låter dig rekrytera Bättre Basilisker.
Upg. Gorgonlya	Gorgonlyan låter dig rekrytera Mäktiga Gorgoner.
Upg. Lindormsnäste	Lindormsnästet låter dig rekrytera Lindormsmonarker.
Upg. Hydrans damm	Hydrans Damm låter dig rekrytera Kaoshydror.
Magisk Lykta	Den Magiska Lyktan låter dig rekrytera Älvor.
Luftaltare	Luftaltaret låter dig rekrytera Luftelementärer.
Vattenaltare	Vattenaltaret låter dig rekrytera Vattenelementärer.
Eldaltare	Eldaltaret låter dig rekrytera Eldelementärer.
Jordaltare	Jordaltaret låter dig rekrytera Jordelementärer.
Tankealtare	The Altar of Thought allows you to recruit Psychic Elementals.
Bål	The Pyre allows you to recruit Fire Birds.
Upg. Magisk Lykta	The Magic Pool allows you to recruit Sprites.
Upg. Luftaltare	Åsktemplet låter dig rekrytera Stormelementärer.
Upg. Vattenaltare	Istemplet låter dig rekrytera Iselementärer.
Upg. Eldaltare	Energitemplet låter dig rekrytera Energielementärer.
Upg. Jordaltare	Magmatemplet låter dig rekrytera Magmaelementärer.
Upg. Tankealtare	Magitemplet låter dig rekrytera Magielementärer.
Upg. Bål	Begravningsbålet låter dig rekrytera Fenixar.
Level 1 Creature Generator	Allows you to recruit Level 1 Creatures.
Level 2 Creature Generator	Allows you to recruit Level 2 Creatures.
Level 3 Creature Generator	Allows you to recruit Level 3 Creatures.
Level 4 Creature Generator	Allows you to recruit Level 4 Creatures.
Level 5 Creature Generator	Allows you to recruit Level 5 Creatures.
Level 6 Creature Generator	Allows you to recruit Level 6 Creatures.
Level 7 Creature Generator	Allows you to recruit Level 7 Creatures.
Upg. Level 1 Creature Generator	Allows you to recruit Upgraded Level 1 Creatures.
Upg. Level 2 Creature Generator	Allows you to recruit Upgraded Level 2 Creatures.
Upg. Level 3 Creature Generator	Allows you to recruit Upgraded Level 3 Creatures.
Upg. Level 4 Creature Generator	Allows you to recruit Upgraded Level 4 Creatures.
Upg. Level 5 Creature Generator	Allows you to recruit Upgraded Level 5 Creatures.
Upg. Level 6 Creature Generator	Allows you to recruit Upgraded Level 6 Creatures.
Upg. Level 7 Creature Generator	Allows you to recruit Upgraded Level 7 Creatures.
