"Note: Do not change the headings in this file, they are used to detect problems"	
Status Bar Message	Tool Tip
"For Help, press F1"	
Create a new map	New Map
Open an existing map	Open Map
Save the current map	Save Map
Save the current map with a new name	Save Map As
"Display program information, version number and copyright"	About
Quit the map editor	Exit
List Help topics	Help Topics
Display help for current task or command	Help
Open this map	
Copy the selected object and put it on the Clipboard	Copy
Cut the selected object and put it on the Clipboard	Cut
Find a specified type of object	
Insert Clipboard contents	Paste
Undo the last action	Undo
Redo the previously undone action	Redo
Change the window size	
Change the window position	
Reduce the window to an icon	
Enlarge the window to full size	
Close the window	
Restore the window to normal size	
View the underground map	Underground
Display the passability of the objects on the map	Passability
Place terrain	Terrain Tool
Place rivers	River Tool
Place roads	Road Tool
Erase objects	Eraser
Place dirt objects	Dirt Objects
Place sand objects	Sand Objects
Place grass objects	Grass Objects
Place snow objects	Snow Objects
Place swamp objects	Swamp Objects
Place rough objects	Rough Objects
Place subterranean objects	Subterranean Objects
Place lava objects	Lava Objects
Place water objects	Water Objects
Place towns	Towns
Place monsters	Monsters
Place heroes	Heroes
Place artifacts	Artifacts
Place treasures	Treasures
Animate the objects on the map	
Modify map specifications	
Select the 1x1-tile terrain brush	1x1-Tile Brush
Select the 2x2-tile terrain brush	2x2-Tile Brush
Select the 4x4-tile terrain brush	4x4-Tile Brush
Select the terrain area brush	Area Brush
Select the dirt terrain type	Dirt
Select the sand terrain type	Sand
Select the grass terrain type	Grass
Select the snow terrain type	Snow
Select the swamp terrain type	Swamp
Select the rough terrain type	Rough
Select the subterranean terrain type	Subterranean
Select the lava terrain type	Lava
Select the water terrain type	Water
Select the clear river type	Clear Rivers
Select the icy river type	Icy Rivers
Select the muddy river type	Muddy Rivers
Select the lava river type	Lava Rivers
Select the gravel road type	Gravel Roads
Select the cobblestone road type	Cobblestone Roads
Select the 1x1-tile eraser brush	1x1-Tile Brush
Select the 2x2-tile eraser brush	2x2-Tile Brush
Select the 4x4-tile eraser brush	4x4-Tile Brush
Select the eraser area brush	Area Brush
Select no player	
Select the %s player	
Select the dirt road type	Dirt Roads
Select the rock terrain type	Rock
Delete the selected object	Delete
Display the properties of the selected object	Properties
Display the tile grid	Grid
Place all-terrain objects	All-Terrain Objects
Select the 1x1-tile brush	1x1-Tile Brush
Select the 2x2-tile brush	2x2-Tile Brush
Select the 4x4-tile brush	4x4-Tile Brush
Select the area brush	Area Brush
Check the map for potential problems	Validate Map
Animate the map terrain	
Modify the application options	
Export the text from the current map to a text file	
Import the text from a text file into the current map	
Describe the currently selected object	
Find the next object of the last specified type	
Find the previous object of the last specified type	
Zoom out the view of the map	Zoom Out
Zoom in the view of the map	Zoom In
Show or hide the toolbar	Toggle Toolbar
Show or hide the status bar	Toggle Status Bar
Show or hide the mode bar	Toggle Mode Bar
Automatically place obstacles	Obstacle Tool
Select the 1x1-tile solid brush	1x1-Tile Solid Brush
Select the 2x2-tile solid brush	2x2-Tile Solid Brush
Select the 4x4-tile solid brush	4x4-Tile Solid Brush
Select the solid area brush	Solid Area Brush
Select the 1x1-tile fuzzy brush	1x1-Tile Fuzzy Brush
Select the 2x2-tile fuzzy brush	2x2-Tile Fuzzy Brush
Select the 4x4-tile fuzzy brush	4x4-Tile Fuzzy Brush
Select the fuzzy area brush	Fuzzy Area Brush
Select the 1x1-tile solid eraser	1x1-Tile Solid Eraser
Select the 2x2-tile solid eraser	2x2-Tile Solid Eraser
Select the 4x4-tile solid eraser	4x4-Tile Solid Eraser
Select the solid area eraser	Solid Area Eraser
Select the 1x1-tile fuzzy eraser	1x1-Tile Fuzzy Eraser
Select the 2x2-tile fuzzy eraser	2x2-Tile Fuzzy Eraser
Select the 4x4-tile fuzzy eraser	4x4-Tile Fuzzy Eraser
Select the fuzzy area eraser	Fuzzy Area Eraser
Place obstacles in marked areas	Place Obstacles
Select the river eraser	River Eraser
Select the road eraser	Road Eraser
